sqi - Albanian  
hye - Armenian  
axe - Azerbaijani  
bos - Bosnian  
bul - Bulgarian  
hrv - Croatian  
ces - Czech  
dan - Danish  
nld - Dutch  
est - Estonian  
fin - Finnish  
fra - French  
deu - German  
ell - Greek  
eng - English  
hun - Hungarian  
isl - Icelandic  
ita - Italian  
lav - Latvian  
lit - Lithuanian  
mkd - Macedonian  
nor - Norwegian  
pol - Polish  
por - Portuguese  
ron - Romanian  
rus - Russian  
srp - Serbian  
slv - Slovenian  
spa - Spanish  
swe - Swedish  
ukr - Ukrainian  
